"aa" = (/turf/space,/area)
"ab" = (/turf/simulated/wall,/area)
"ac" = (/turf/simulated/floor,/area)
"ad" = (/turf/simulated/floor{icon_state = "yellow"; dir = 1},/area)
"ae" = (/turf/simulated/floor/plating,/area)
"af" = (/turf/simulated/wall/r_wall,/area)
"ag" = (/turf/simulated/floor{dir = 4; icon_state = "yellow"},/area)
"ah" = (/turf/simulated/floor/plating{icon_state = "warnplate"; dir = 9},/area)
"ai" = (/obj/machinery/atmospherics/pipe/simple/insulated/visible{tag = "icon-intact (SOUTHEAST)"; icon_state = "intact"; dir = 6},/turf/simulated/floor/plating{icon_state = "warnplate"; dir = 1},/area)
"aj" = (/obj/machinery/atmospherics/pipe/simple/insulated/visible{dir = 10},/turf/simulated/floor/plating{icon_state = "warnplate"; dir = 1},/area)
"ak" = (/obj/machinery/hologram/holopad,/turf/simulated/floor/plating{icon_state = "warnplate"; dir = 1},/area)
"al" = (/obj/machinery/atmospherics/pipe/simple/insulated/visible/blue{dir = 6},/turf/simulated/floor/plating{icon_state = "warnplate"; dir = 1},/area)
"am" = (/obj/machinery/atmospherics/pipe/simple/insulated/visible/blue{tag = "icon-intact (SOUTHWEST)"; icon_state = "intact"; dir = 10},/turf/simulated/floor/plating{icon_state = "warnplate"; dir = 1},/area)
"an" = (/turf/simulated/floor/plating{icon_state = "warnplate"; dir = 5},/area)
"ao" = (/turf/simulated/floor{dir = 8; icon_state = "yellow"},/area)
"ap" = (/obj/machinery/portable_atmospherics/canister/oxygen,/turf/simulated/floor/plating,/area)
"aq" = (/obj/machinery/door/airlock/external{name = "External Access"; req_access = null; req_access_txt = "13"},/turf/simulated/floor/plating,/area)
"ar" = (/turf/simulated/floor/plating{icon_state = "warnplate"; dir = 8},/area)
"as" = (/obj/machinery/atmospherics/pipe/simple/insulated/visible,/turf/simulated/floor/plating,/area)
"at" = (/obj/machinery/atmospherics/binary/volume_pump{dir = 1; name = "Hot Gas Circulator"},/turf/simulated/floor/plating,/area)
"au" = (/obj/machinery/atmospherics/binary/volume_pump{name = "Cold Gas Circulator"},/turf/simulated/floor/plating,/area)
"av" = (/obj/machinery/atmospherics/pipe/simple/insulated/visible/blue,/turf/simulated/floor/plating,/area)
"aw" = (/turf/simulated/floor/plating{icon_state = "warnplate"; dir = 4},/area)
"ax" = (/obj/machinery/portable_atmospherics/canister/toxins,/turf/simulated/floor/plating,/area)
"ay" = (/turf/simulated/floor/plating{icon_state = "warnplate"; dir = 10},/area)
"az" = (/obj/machinery/atmospherics/portables_connector{dir = 4},/obj/machinery/atmospherics/pipe/simple/insulated/visible,/turf/simulated/floor/plating,/area)
"aA" = (/obj/machinery/atmospherics/pipe/manifold/insulated/hidden{dir = 4},/turf/simulated/floor/plating,/area)
"aB" = (/obj/machinery/atmospherics/pipe/manifold/insulated/hidden/blue{dir = 8},/turf/simulated/floor/plating,/area)
"aC" = (/obj/machinery/atmospherics/portables_connector{dir = 8},/obj/machinery/atmospherics/pipe/simple/insulated/visible/blue,/turf/simulated/floor/plating,/area)
"aD" = (/turf/simulated/floor/plating{icon_state = "warnplate"; dir = 6},/area)
"aE" = (/turf/simulated/floor{icon_state = "warningcorner"; dir = 8},/area)
"aF" = (/obj/machinery/atmospherics/pipe/simple/insulated/visible,/obj/machinery/meter{name = "Hot Loop"},/turf/simulated/floor/plating{icon_state = "warnplate"; dir = 8},/area)
"aG" = (/obj/machinery/atmospherics/binary/circulator{anchored = 1; dir = 1},/turf/simulated/floor/plating,/area)
"aH" = (/obj/machinery/power/generator{anchored = 1; dir = 4},/turf/simulated/floor/plating,/area)
"aI" = (/obj/machinery/atmospherics/binary/circulator{anchored = 1},/turf/simulated/floor/plating,/area)
"aJ" = (/obj/machinery/meter{name = "Cold Loop"},/obj/machinery/atmospherics/pipe/simple/insulated/visible/blue,/turf/simulated/floor/plating{icon_state = "warnplate"; dir = 4},/area)
"aK" = (/turf/simulated/floor{icon_state = "warningcorner"; dir = 4},/area)
"aL" = (/obj/machinery/atmospherics/pipe/manifold/insulated/hidden{dir = 8},/turf/simulated/floor/plating{icon_state = "warnplate"; dir = 8},/area)
"aM" = (/obj/machinery/atmospherics/pipe/simple/insulated/visible{tag = "icon-intact (NORTHWEST)"; icon_state = "intact"; dir = 9},/turf/simulated/floor/plating,/area)
"aN" = (/obj/machinery/atmospherics/pipe/simple/insulated/visible/blue{tag = "icon-intact (NORTHEAST)"; icon_state = "intact"; dir = 5},/turf/simulated/floor/plating,/area)
"aO" = (/obj/machinery/atmospherics/pipe/manifold/insulated/hidden/blue{dir = 4},/turf/simulated/floor/plating{icon_state = "warnplate"; dir = 4},/area)
"aP" = (/obj/machinery/atmospherics/pipe/simple/insulated/visible,/turf/simulated/floor/plating{icon_state = "warnplate"; dir = 8},/area)
"aQ" = (/obj/machinery/atmospherics/pipe/simple/insulated/visible/blue,/turf/simulated/floor/plating{icon_state = "warnplate"; dir = 4},/area)
"aR" = (/obj/structure/lattice,/turf/space,/area)
"aS" = (/obj/machinery/atmospherics/pipe/simple/supply/hidden{dir = 6},/turf/simulated/wall,/area)
"aT" = (/obj/machinery/atmospherics/pipe/simple/supply/hidden{dir = 4},/turf/simulated/wall,/area)
"aU" = (/obj/structure/lattice,/obj/structure/grille,/turf/space,/area)
"aV" = (/obj/machinery/atmospherics/pipe/simple/supply/hidden{dir = 5},/turf/simulated/wall,/area)
"aW" = (/obj/machinery/airlock_sensor{id_tag = "inc_chamber_airlock_sensor"; master_tag = "inc_airlock_control"; pixel_x = -24},/obj/machinery/light/small{dir = 1},/obj/machinery/atmospherics/binary/dp_vent_pump/high_volume{dir = 4; frequency = 1449; id_tag = "inc_airlock_pump"},/turf/simulated/floor/engine{icon_state = "enginedelivery"},/area)
"aX" = (/obj/machinery/door/airlock/glass_research{autoclose = 0; frequency = 1449; icon_state = "door_locked"; id_tag = "inc_airlock_interior"; locked = 1; name = "Incinerator Interior Airlock"; req_access_txt = "8"},/obj/effect/decal/warning_stripes{icon_state = "unloading"},/obj/machinery/atmospherics/pipe/simple/scrubbers/hidden{dir = 4},/turf/simulated/floor/engine,/area)
"aY" = (/obj/machinery/airlock_sensor{id_tag = "inc_int_airlock_sensor"; master_tag = "inc_airlock_control"; pixel_y = 24},/obj/effect/decal/warning_stripes{icon_state = "no"},/obj/effect/decal/warning_stripes{icon_state = "oxygen"; dir = 4},/obj/effect/decal/warning_stripes{icon_state = "old"; dir = 8},/turf/simulated/floor/plating,/area)
"aZ" = (/obj/machinery/atmospherics/portables_connector,/obj/effect/decal/warning_stripes{icon_state = "bot"},/turf/simulated/floor/plating,/area)
"ba" = (/turf/space,/obj/machinery/atmospherics/pipe/simple/heat_exchanging{dir = 6},/turf/simulated/floor/plating/airless/catwalk,/area)
"bb" = (/obj/machinery/atmospherics/pipe/simple/heat_exchanging{dir = 4},/turf/space,/area)
"bc" = (/obj/structure/lattice,/obj/machinery/atmospherics/pipe/simple/heat_exchanging{dir = 4},/turf/space,/area)
"bd" = (/obj/structure/lattice,/obj/machinery/atmospherics/pipe/simple/heat_exchanging{dir = 10},/turf/space,/area)
"be" = (/turf/space,/turf/simulated/floor/plating/airless/catwalk,/area)
"bf" = (/obj/machinery/door/airlock/glass_research{autoclose = 0; frequency = 1449; icon_state = "door_locked"; id_tag = "inc_airlock_exterior"; locked = 1; name = "Incinerator Exterior Airlock"; req_access_txt = "8"},/obj/effect/decal/warning_stripes{icon_state = "unloading"},/turf/simulated/floor/engine{name = "vacuum floor"; nitrogen = 0.01; oxygen = 0.01},/area)
"bg" = (/obj/machinery/embedded_controller/radio/advanced_airlock_controller{frequency = 1449; id_tag = "inc_airlock_control"; pixel_x = -24; tag_airpump = "inc_airlock_pump"; tag_chamber_sensor = "inc_chamber_airlock_sensor"; tag_exterior_door = "inc_airlock_exterior"; tag_exterior_sensor = "inc_ext_airlock_sensor"; tag_interior_door = "inc_airlock_interior"; tag_interior_sensor = "inc_int_airlock_sensor"},/obj/machinery/light{dir = 8},/obj/effect/decal/warning_stripes{icon_state = "corner"; dir = 4},/turf/simulated/floor/plating,/area)
"bh" = (/obj/machinery/atmospherics/pipe/simple/insulated/visible{dir = 5},/turf/simulated/floor/plating,/area)
"bi" = (/obj/machinery/atmospherics/pipe/simple/insulated/visible{dir = 4},/turf/simulated/floor/plating,/area)
"bj" = (/obj/machinery/atmospherics/pipe/simple/insulated/visible{dir = 10},/turf/simulated/floor/plating,/area)
"bk" = (/obj/machinery/atmospherics/binary/pump{name = "Hot Fill Pump"},/turf/simulated/floor/plating,/area)
"bl" = (/obj/machinery/atmospherics/binary/pump{name = "Cold Fill Pump"},/turf/simulated/floor/plating,/area)
"bm" = (/obj/structure/grille,/obj/structure/window/reinforced{dir = 1},/obj/structure/window/reinforced{dir = 4},/obj/structure/window/reinforced{dir = 8},/turf/simulated/floor/plating,/area)
"bn" = (/turf/space,/obj/machinery/atmospherics/pipe/simple/heat_exchanging,/turf/simulated/floor/plating/airless/catwalk,/area)
"bo" = (/obj/machinery/atmospherics/pipe/simple/heat_exchanging{dir = 6},/turf/space,/area)
"bp" = (/obj/structure/lattice,/obj/machinery/atmospherics/pipe/simple/heat_exchanging{dir = 9},/turf/space,/area)
"bq" = (/obj/machinery/atmospherics/pipe/simple/heat_exchanging{dir = 6},/turf/simulated/floor/engine{name = "vacuum floor"; nitrogen = 0.01; oxygen = 0.01},/area)
"br" = (/obj/machinery/atmospherics/pipe/simple/heat_exchanging{dir = 4},/turf/simulated/floor/engine{name = "vacuum floor"; nitrogen = 0.01; oxygen = 0.01},/area)
"bs" = (/obj/machinery/airlock_sensor{id_tag = "inc_ext_airlock_sensor"; master_tag = "inc_airlock_control"; pixel_y = 24},/obj/machinery/atmospherics/pipe/simple/heat_exchanging{dir = 4},/turf/simulated/floor/engine{name = "vacuum floor"; nitrogen = 0.01; oxygen = 0.01},/area)
"bt" = (/obj/machinery/atmospherics/pipe/simple/heat_exchanging{dir = 4},/obj/effect/decal/warning_stripes{icon_state = "loadingarea"},/turf/simulated/floor/engine{name = "vacuum floor"; nitrogen = 0.01; oxygen = 0.01},/area)
"bu" = (/obj/structure/window/full/plasmareinforced,/obj/machinery/atmospherics/pipe/simple/heat_exchanging/junction{dir = 8},/obj/structure/window/plasmareinforced{dir = 8},/obj/structure/window/plasmareinforced{dir = 1},/obj/structure/window/plasmareinforced{dir = 4},/obj/structure/grille,/turf/simulated/floor/plating/airless,/area)
"bv" = (/obj/effect/decal/warning_stripes{icon_state = "bot"},/obj/machinery/atmospherics/portables_connector,/obj/machinery/atmospherics/unary/cap/hidden/general{tag = "icon-cap (WEST)"; icon_state = "cap"; dir = 8},/turf/simulated/floor/plating,/area)
"bw" = (/obj/effect/decal/warning_stripes{icon_state = "bot"},/obj/machinery/atmospherics/portables_connector,/turf/simulated/floor/plating,/area)
"bx" = (/obj/machinery/atmospherics/pipe/simple/insulated/visible/blue{tag = "icon-intact (EAST)"; icon_state = "intact"; dir = 4},/obj/machinery/atmospherics/pipe/simple/insulated/visible,/turf/simulated/floor/plating,/area)
"by" = (/obj/machinery/meter{name = "Cold Loop"},/obj/machinery/atmospherics/pipe/manifold/insulated/visible/blue,/turf/simulated/floor/plating,/area)
"bz" = (/obj/machinery/atmospherics/pipe/simple/insulated/visible/blue{tag = "icon-intact (EAST)"; icon_state = "intact"; dir = 4},/turf/simulated/floor/plating,/area)
"bA" = (/obj/machinery/atmospherics/pipe/simple/heat_exchanging/junction{dir = 4},/obj/structure/grille,/obj/structure/window/reinforced{dir = 4},/obj/structure/window/reinforced{dir = 8},/turf/simulated/floor/plating,/area)
"bB" = (/turf/space,/obj/machinery/atmospherics/pipe/simple/heat_exchanging{dir = 9},/turf/simulated/floor/plating/airless/catwalk,/area)
"bC" = (/obj/machinery/atmospherics/pipe/simple/heat_exchanging{dir = 5},/turf/space,/area)
"bD" = (/obj/machinery/atmospherics/pipe/simple/heat_exchanging{dir = 5},/turf/simulated/floor/engine{name = "vacuum floor"; nitrogen = 0.01; oxygen = 0.01},/area)
"bE" = (/obj/machinery/atmospherics/pipe/simple/heat_exchanging{dir = 10},/obj/machinery/atmospherics/unary/outlet_injector{dir = 4; frequency = 1449; id_tag = "inc_in"},/obj/effect/decal/warning_stripes{icon_state = "bot"},/turf/simulated/floor/engine{name = "vacuum floor"; nitrogen = 0.01; oxygen = 0.01},/area)
"bF" = (/obj/structure/window/full/plasmareinforced,/obj/machinery/atmospherics/pipe/simple/yellow/hidden{dir = 4},/obj/structure/window/plasmareinforced{dir = 8},/obj/structure/window/plasmareinforced{dir = 4},/obj/structure/grille,/turf/simulated/floor/plating/airless,/area)
"bG" = (/obj/structure/table,/obj/machinery/meter{name = "Fuel Meter"},/obj/machinery/atmospherics/pipe/manifold/insulated/visible,/turf/simulated/floor/plating,/area)
"bH" = (/obj/structure/table,/obj/machinery/atmospherics/pipe/manifold/insulated/visible,/turf/simulated/floor/plating,/area)
"bI" = (/obj/structure/table,/obj/machinery/atmospherics/pipe/simple/insulated/visible{tag = "icon-intact (NORTHWEST)"; icon_state = "intact"; dir = 9},/turf/simulated/floor/plating,/area)
"bJ" = (/obj/machinery/atmospherics/pipe/simple/insulated/visible/blue{dir = 6},/turf/simulated/floor/plating,/area)
"bK" = (/turf/space,/obj/machinery/atmospherics/pipe/simple/heat_exchanging{dir = 10},/turf/simulated/floor/plating/airless/catwalk,/area)
"bL" = (/obj/machinery/atmospherics/pipe/simple/heat_exchanging{dir = 9},/obj/machinery/air_sensor{frequency = 1449; id_tag = "inc_sensor"; output = 63},/turf/simulated/floor/engine{name = "vacuum floor"; nitrogen = 0.01; oxygen = 0.01},/area)
"bM" = (/obj/structure/window/full/plasmareinforced,/obj/structure/window/plasmareinforced{dir = 8},/obj/structure/window/plasmareinforced{dir = 4},/obj/structure/grille,/turf/simulated/floor/plating/airless,/area)
"bN" = (/obj/machinery/computer/general_air_control/atmos_automation/burnchamber,/obj/effect/decal/warning_stripes{icon_state = "old"; dir = 5},/turf/simulated/floor{icon_state = "dark"},/area)
"bO" = (/obj/machinery/door_control{desc = "Lets all the hot gas out very quickly."; id_tag = "Burn Chamber Vent"; name = "Burn Chamber Vent"; pixel_x = -7; pixel_y = 32; req_access_txt = "0"},/obj/machinery/ignition_switch{id_tag = "Burn Chamber Igniter"; pixel_x = 6; pixel_y = 32},/turf/simulated/floor/plating,/area)
"bP" = (/obj/machinery/atmospherics/pipe/manifold/insulated/visible{tag = "icon-manifold (WEST)"; icon_state = "manifold"; dir = 8},/turf/simulated/floor/plating,/area)
"bQ" = (/obj/machinery/atmospherics/pipe/simple/insulated/visible/blue,/obj/machinery/atmospherics/pipe/simple/insulated/visible{dir = 4},/turf/simulated/floor/plating,/area)
"bR" = (/obj/structure/grille,/obj/structure/window/reinforced{dir = 4},/obj/structure/window/reinforced{dir = 8},/turf/simulated/floor/plating,/area)
"bS" = (/obj/machinery/atmospherics/pipe/simple/heat_exchanging{dir = 4},/obj/machinery/igniter{id_tag = "Burn Chamber Igniter"},/obj/effect/decal/warning_stripes{icon_state = "bot"},/turf/simulated/floor/engine{name = "vacuum floor"; nitrogen = 0.01; oxygen = 0.01},/area)
"bT" = (/obj/structure/window/full/plasmareinforced,/obj/machinery/atmospherics/pipe/simple/heat_exchanging/junction{dir = 8},/obj/structure/window/plasmareinforced{dir = 8},/obj/structure/window/plasmareinforced{dir = 4},/obj/structure/grille,/turf/simulated/floor/plating/airless,/area)
"bU" = (/obj/machinery/computer/general_air_control/large_tank_control{frequency = 1449; input_tag = "inc_in"; output_tag = "inc_out"; sensors = list("inc_sensor" = "Tank")},/obj/effect/decal/warning_stripes{icon_state = "old"; dir = 6},/obj/machinery/atmospherics/pipe/simple/insulated/visible{dir = 4},/turf/simulated/floor{icon_state = "dark"},/area)
"bV" = (/obj/machinery/atmospherics/pipe/manifold/insulated/visible{tag = "icon-manifold (NORTH)"; icon_state = "manifold"; dir = 1},/turf/simulated/floor/plating,/area)
"bW" = (/obj/machinery/meter{name = "Hot Loop"},/obj/machinery/atmospherics/pipe/manifold/insulated/visible{tag = "icon-manifold (NORTH)"; icon_state = "manifold"; dir = 1},/turf/simulated/floor/plating,/area)
"bX" = (/obj/structure/lattice,/obj/structure/grille,/obj/structure/lattice,/turf/space,/area)
"bY" = (/turf/space,/obj/machinery/atmospherics/pipe/vent/high_volume{dir = 4},/turf/simulated/floor/plating/airless/catwalk,/area)
"bZ" = (/obj/machinery/atmospherics/pipe/simple/insulated/hidden{dir = 4},/turf/simulated/wall/r_wall,/area)
"ca" = (/obj/machinery/atmospherics/pipe/manifold/insulated/hidden{dir = 1},/turf/simulated/floor/engine{name = "vacuum floor"; nitrogen = 0.01; oxygen = 0.01},/area)
"cb" = (/obj/structure/window/full/plasmareinforced,/obj/machinery/atmospherics/pipe/manifold/insulated/hidden{dir = 1},/obj/structure/window/plasmareinforced{dir = 8},/obj/structure/window/plasmareinforced{dir = 4},/obj/structure/grille,/obj/machinery/meter{name = "Vent Gas Meter"},/turf/simulated/floor/plating/airless,/area)
"cc" = (/obj/machinery/atmospherics/valve/digital{dir = 4; name = "Hot Loop Release Valve"},/turf/simulated/floor/plating{icon_state = "warnplate"; dir = 5},/area)
"cd" = (/obj/machinery/atmospherics/valve/digital{name = "Hot-Cold Bypass Valve"},/turf/simulated/floor/plating,/area)
"ce" = (/obj/machinery/atmospherics/portables_connector{dir = 1; name = "Hot Tap"},/obj/effect/decal/warning_stripes{icon_state = "bot"},/turf/simulated/floor/plating,/area)
"cf" = (/obj/effect/decal/warning_stripes{icon_state = "bot"},/obj/machinery/atmospherics/portables_connector{dir = 2; name = "Cold Tap"},/turf/simulated/floor/plating,/area)
"cg" = (/obj/machinery/atmospherics/unary/vent_scrubber{dir = 1; frequency = 1449; id_tag = "inc_out"; name = "Burn Chamber Scrubber"; on = 1},/obj/effect/decal/warning_stripes{icon_state = "bot"},/turf/simulated/floor/engine{name = "vacuum floor"; nitrogen = 0.01; oxygen = 0.01},/area)
"ch" = (/obj/structure/window/full/plasmareinforced,/obj/machinery/atmospherics/pipe/simple/insulated/hidden{dir = 5},/obj/structure/window/plasmareinforced,/obj/structure/window/plasmareinforced{dir = 8},/obj/structure/window/plasmareinforced{dir = 4},/obj/structure/grille,/turf/simulated/floor/plating/airless,/area)
"ci" = (/obj/machinery/atmospherics/valve/digital{dir = 4; name = "Cold Loop Release Valve"},/turf/simulated/floor/plating{icon_state = "warnplate"; dir = 6},/area)
"cj" = (/obj/machinery/atmospherics/pipe/manifold/insulated/visible/blue,/turf/simulated/floor/plating,/area)
"ck" = (/obj/machinery/atmospherics/pipe/simple/insulated/visible/blue{tag = "icon-intact (NORTHWEST)"; icon_state = "intact"; dir = 9},/turf/simulated/floor/plating,/area)
"cl" = (/obj/structure/window/reinforced{dir = 8},/obj/machinery/portable_atmospherics/canister/carbon_dioxide,/obj/effect/decal/warning_stripes{icon_state = "old"; dir = 1},/turf/simulated/floor/plating{icon_state = "warnplate"; dir = 1},/area)
"cm" = (/obj/machinery/portable_atmospherics/canister/carbon_dioxide,/obj/effect/decal/warning_stripes{icon_state = "old"; dir = 1},/turf/simulated/floor/plating{icon_state = "warnplate"; dir = 1},/area)
"cn" = (/obj/effect/decal/warning_stripes{icon_state = "unloading"},/obj/machinery/door/poddoor{id_tag = "Burn Chamber Vent"; name = "Burn Chamber Vent"},/turf/simulated/floor/engine{name = "vacuum floor"; nitrogen = 0.01; oxygen = 0.01},/area)
"co" = (/obj/structure/window/reinforced{dir = 8},/obj/machinery/portable_atmospherics/canister/carbon_dioxide,/turf/simulated/floor/plating,/area)
"cp" = (/obj/machinery/portable_atmospherics/canister/carbon_dioxide,/turf/simulated/floor/plating,/area)
"cq" = (/obj/structure/grille,/obj/structure/window/reinforced,/obj/structure/window/reinforced{dir = 4},/obj/structure/window/reinforced{dir = 8},/turf/simulated/floor/plating,/area)
"cr" = (/turf/space,/obj/machinery/atmospherics/pipe/simple/heat_exchanging{dir = 5},/turf/simulated/floor/plating/airless/catwalk,/area)

(1,1,1) = {"
aaaaaaaaaaaaaaaaaaaaaaaaaaaaaaaaaaaaaaaaaaaaaaaaaaaaaaaaaaaaaaaaaaaaaaaaaaaaaaaaaaaaaaaaaaaaaaaaaaaa
aaaaaaaaaaaaaaaaaaaaaaaaaaaaaaaaaaaaaaaaaaaaaaaaaaaaaaaaaaaaaaaaaaaaaaaaaaaaaaaaaaaaaaaaaaaaaaaaaaaa
aaaaaaaaaaaaaaaaaaaaaaaaaaaaaaaaaaaaaaaaaaaaaaaaaaaaaaaaaaaaaaaaaaaaaaaaaaaaaaaaaaaaaaaaaaaaaaaaaaaa
aaaaaaaaaaaaaaaaaaaaaaaaaaaaaaaaaaaaaaaaaaaaaaaaaaaaaaaaaaaaaaaaaaaaaaaaaaaaaaaaaaaaaaaaaaaaaaaaaaaa
aaaaaaaaaaaaaaaaaaaaaaaaaaaaaaaaaaaaaaaaaaaaaaaaaaaaaaaaaaaaaaaaaaaaaaaaaaaaaaaaaaaaaaaaaaaaaaaaaaaa
aaaaaaaaaaaaaaaaaaaaaaaaaaaaaaaaaaaaaaaaaaaaaaaaaaaaaaaaaaaaaaaaaaaaaaaaaaaaaaaaaaaaaaaaaaaaaaaaaaaa
aaaaaaaaaaaaaaaaaaaaaaaaaaaaaaaaaaaaaaaaaaaaaaaaaaaaaaaaaaaaaaaaaaaaaaaaaaaaaaaaaaaaaaaaaaaaaaaaaaaa
aaaaaaaaaaaaaaaaaaaaaaaaaaaaaaaaaaaaaaaaaaaaaaaaaaaaaaaaaaaaaaaaaaaaaaaaaaaaaaaaaaaaaaaaaaaaaaaaaaaa
aaaaaaaaaaaaaaaaaaaaaaaaaaaaaaaaaaaaaaaaaaaaaaaaaaaaaaaaaaaaaaaaaaaaaaaaaaaaaaaaaaaaaaaaaaaaaaaaaaaa
aaaaaaaaaaaaaaaaaaaaaaaaaaaaaaaaaaaaaaaaaaaaaaaaaaaaaaaaaaaaaaaaaaaaaaaaaaaaaaaaaaaaaaaaaaaaaaaaaaaa
aaaaaaaaaaaaaaaaaaaaaaaaaaaaaaaaaaaaaaaaaaaaaaaaaaaaaaaaaaaaaaaaaaaaaaaaaaaaaaaaaaaaaaaaaaaaaaaaaaaa
aaaaaaaaaaaaaaaaaaaaaaaaaaaaaaaaaaaaaaaaaaaaaaaaaaaaaaaaaaaaaaaaaaaaaaaaaaaaaaaaaaaaaaaaaaaaaaaaaaaa
aaaaaaaaaaaaaaaaaaaaaaaaaaaaaaaaaaaaaaaaaaaaaaaaaaaaaaaaaaaaaaaaaaaaaaaaaaaaaaaaaaaaaaaaaaaaaaaaaaaa
aaaaaaaaaaaaaaaaaaabababababacacababacabababacacacabababacababacacabababababaaaaaaaaaaaaaaaaaaaaaaaa
aaaaaaaaaaaaaaaaaaaaaaaaaaabacacabacadacacabaeaeaeabacacadacabacacabaaaaaaaaaaaaaaaaaaaaaaaaaaaaaaaa
aaaaaaaaaaaaaaaaaaaaaaaaaaabacacabacacacacacacacacacacacacacabacacabaaaaaaaaaaaaaaaaaaaaaaaaaaaaaaaa
aaaaaaaaaaaaaaaaaaafafafafafacagaeacacacahaiajakalamanacacacaeaoacafafafafafaaaaaaaaaaaaaaaaaaaaaaaa
aaaaaaaaaaaaaaaaaaafapapaeaqacagaeacacacarasataeauavawacacacaeaoacaqaeaxaxafaaaaaaaaaaaaaaaaaaaaaaaa
aaaaaaaaaaaaaaaaaaafapapaeafacagaeacacacayazaAaeaBaCaDacacacaeaoacafaeaxaxafaaaaaaaaaaaaaaaaaaaaaaaa
aaaaaaaaaaaaaaaaaaafapapapafacacababacacaEaFaGaHaIaJaKacacababacacafaxaxaxafaaaaaaaaaaaaaaaaaaaaaaaa
aaaaaaaaaaaaaaaaaaafafafafafacacacababababaLaMaeaNaOababababacacacafafafafafaaaaaaaaaaaaaaaaaaaaaaaa
aaaaaaaaaaaaaaaaaaaaaaaaaaabacacacacacacacaPaeaeaeaQacacacacacacacabaaaaaaaaaaaaaaaaaaaaaaaaaaaaaaaa
aaaaaaaaaaaaaaaaaaaaaaaaaaabacacacacacacacaPaeaeaeaQacacacacacacacabaaaaaaaaaaaaaaaaaaaaaaaaaaaaaaaa
aaaaaaaaaaaaaaaaaaaaaaaaaaabacacacacacacacaPaeaeaeaQacacacacacacacabaaaaaaaaaaaaaaaaaaaaaaaaaaaaaaaa
aaaaaaaaaaaaaaaaaaaaaaaRaaababaSaTaTabababaPaeaeaeaQababababababababaUaUaUaUaUaUaUaaaaaaaaaaaaaaaaaa
aaaaaaaaaaaaaRaRaRaRaRaRaaaaaaaVaWaXaYaeaeasaeaeaeavaZaZaeabbabbbbbcbbbbbcbbbbbdaUaaaaaaaaaaaaaaaaaa
aaaaaaaaaaaaaRaabeafafafafafafafbfafbgaeaebhbibjaeavbkblaebmbnbobbbcbbbbbcbbbbbpaUaaaaaaaaaaaaaaaaaa
aaaaaaaaaaaaaRaabeafbqbrbrbrbrbsbtbubvbwbwbwaeasaeaNbxbybzbAbBbCbbbcbbbbbcbbbbbdaUaaaaaaaaaaaaaaaaaa
aaaaaaaaaaaaaRaabeafbDbrbrbrbrbrbEbFbGbHbHbIaeasbJbzbxbzbzbAbKbobbbcbbbbbcbbbbbpaUaaaaaaaaaaaaaaaaaa
aaaaaaaaaaaaaRaRbeafbqbrbrbrbrbrbLbMbNbOaeaeaebPbQbiaMaeaebRbnbCbbbcbbbbbcbbbbbdaUaaaaaaaaaaaaaaaaaa
aaaaaaaaaaaaaRaabeafbDbrbrbrbrbrbSbTbUbVbibWbVaMavaeaeaeaebRbnbobbbcbbbbbcbbbbbpbXaaaaaaaaaaaaaaaaaa
aaaaaaaaaaaaaRaabYbZcacacacacacacacbccaMaecdcecfavaeaeaeaebRbnbCbbbcbbbbbcbbbbbdbXaaaaaaaaaaaaaaaaaa
aaaaaaaaaaaaaRaabeafcgcgcgcgcgcgcgchcibzbzbybzcjckaeaeclcmbRbnbobbbcbbbbbcbbbbbpaUaaaaaaaaaaaaaaaaaa
aaaaaaaaaaaaaRaRbeafcncncncncncncnafaeaeaeaeaeaeaeaeaecocpcqbnbCbbbcbbbbbcbbbbbdaUaaaaaaaaaaaaaaaaaa
aaaaaaaaaaaaaRaabebebebebebebebebeabababababababababababababcrbbbbbcbbbbbcbbbbbpaUaaaaaaaaaaaaaaaaaa
aaaaaaaaaaaaaRaaaaaRaaaaaaaaaaaaaRaRaRaaaaaaaaaaaaaaaaaaaaabaUaUaUaUaUaUaUaUaUaUaUaaaaaaaaaaaaaaaaaa
aaaaaaaaaaaaaaaaaabeaaaaaaaaaaaaaaaRaaaaaaaaaaaaaaaaaaaaaaaaaaaaaaaaaaaaaaaaaaaaaaaaaaaaaaaaaaaaaaaa
aaaaaaaaaaaaaaaaaaaaaaaaaaaaaaaaaaaaaaaaaaaaaaaaaaaaaaaaaaaaaaaaaaaaaaaaaaaaaaaaaaaaaaaaaaaaaaaaaaaa
aaaaaaaaaaaaaaaaaaaaaaaaaaaaaaaaaaaaaaaaaaaaaaaaaaaaaaaaaaaaaaaaaaaaaaaaaaaaaaaaaaaaaaaaaaaaaaaaaaaa
aaaaaaaaaaaaaaaaaaaaaaaaaaaaaaaaaaaaaaaaaaaaaaaaaaaaaaaaaaaaaaaaaaaaaaaaaaaaaaaaaaaaaaaaaaaaaaaaaaaa
aaaaaaaaaaaaaaaaaaaaaaaaaaaaaaaaaaaaaaaaaaaaaaaaaaaaaaaaaaaaaaaaaaaaaaaaaaaaaaaaaaaaaaaaaaaaaaaaaaaa
aaaaaaaaaaaaaaaaaaaaaaaaaaaaaaaaaaaaaaaaaaaaaaaaaaaaaaaaaaaaaaaaaaaaaaaaaaaaaaaaaaaaaaaaaaaaaaaaaaaa
aaaaaaaaaaaaaaaaaaaaaaaaaaaaaaaaaaaaaaaaaaaaaaaaaaaaaaaaaaaaaaaaaaaaaaaaaaaaaaaaaaaaaaaaaaaaaaaaaaaa
aaaaaaaaaaaaaaaaaaaaaaaaaaaaaaaaaaaaaaaaaaaaaaaaaaaaaaaaaaaaaaaaaaaaaaaaaaaaaaaaaaaaaaaaaaaaaaaaaaaa
aaaaaaaaaaaaaaaaaaaaaaaaaaaaaaaaaaaaaaaaaaaaaaaaaaaaaaaaaaaaaaaaaaaaaaaaaaaaaaaaaaaaaaaaaaaaaaaaaaaa
aaaaaaaaaaaaaaaaaaaaaaaaaaaaaaaaaaaaaaaaaaaaaaaaaaaaaaaaaaaaaaaaaaaaaaaaaaaaaaaaaaaaaaaaaaaaaaaaaaaa
aaaaaaaaaaaaaaaaaaaaaaaaaaaaaaaaaaaaaaaaaaaaaaaaaaaaaaaaaaaaaaaaaaaaaaaaaaaaaaaaaaaaaaaaaaaaaaaaaaaa
aaaaaaaaaaaaaaaaaaaaaaaaaaaaaaaaaaaaaaaaaaaaaaaaaaaaaaaaaaaaaaaaaaaaaaaaaaaaaaaaaaaaaaaaaaaaaaaaaaaa
aaaaaaaaaaaaaaaaaaaaaaaaaaaaaaaaaaaaaaaaaaaaaaaaaaaaaaaaaaaaaaaaaaaaaaaaaaaaaaaaaaaaaaaaaaaaaaaaaaaa
aaaaaaaaaaaaaaaaaaaaaaaaaaaaaaaaaaaaaaaaaaaaaaaaaaaaaaaaaaaaaaaaaaaaaaaaaaaaaaaaaaaaaaaaaaaaaaaaaaaa
"}
